00000000000000000000
00000000000000000000
00000000000000000000
00000000000000000000
00000000000000000000
00000000000000000000
00000000000000000000
00000000022000000000
00000000000000440000
11111111000011111113
11111111000011111113
